TTTTTTTTT
TOOOOOOFT
TOOTOTTOT
TOTOOOOOT
TOOOTTOOT
TOTOTOOTT
TOTOOTOOT
TFOOOOTOT
TTTTTTTTT