5
TTTTTTTTT
TOOOOOOOT
TOTOTOTOT
TOTOTOTOT
TOTFTOTOT