TTTTTTTTT
TOOOOOTFT
TOOTOTTOT
TOTOOOOOT
TOOOTTOOT
TOTOTOOTT
TOTOOOOOT
TFOOOOTOT
TTTTTTTTT