9
TTTTTTTTT
TOOOOOTFT
TOOTOTTOT
TOTOOOOOT
TOOOTTOOT
TOTOTOOTT
TOTOOOOOT
TOOOOOTOT
TTTTTTTTT