TTTTTTTT
TOOTOOFT
TTOOTOOT
TTOTOOTT
TOOOOOOT
TTOTOOOT
TFOOOTOT
TTTTTTTT
